No	From	To	Tokens	TokenBalance	Block	TxIndex	TxHash
0	0x0000000000000000000000000000000000000000	0xa33a6c312d9ad0e0f2e95541beed0cc081621fd0	1000	1000	3733	0	0xa529093c8ead1a194da128e88354be06dbe222fb3273d0cbac7a4cce4532021f
1	0x0000000000000000000000000000000000000000	0xa44a08d3f6933c69212114bb66e2df1813651844	10000	11000	3733	1	0x65a02b90a87d6c490c371047c856f3d829b626df4f8cec2ba3160647c138ee8e
2	0x0000000000000000000000000000000000000000	0xa55a151eb00fded1634d27d1127b4be4627079ea	14000	25000	3736	0	0xadf6be3109bb72704f3a1c6ecdbd38dc734098e8f17bb9a89a0a9ef5262b8313
3	0x0000000000000000000000000000000000000000	0xa22ab8a9d641ce77e06d98b7d7065d324d3d6976	6000	31000	3736	0	0xadf6be3109bb72704f3a1c6ecdbd38dc734098e8f17bb9a89a0a9ef5262b8313
4	0x0000000000000000000000000000000000000000	0xa66a85ede0cbe03694aa9d9de0bb19c99ff55bd9	28000	59000	3736	1	0x2a4085d1bd2b09066fa478d50c4249b132cb674a94af3b8398056f3351ed7941
5	0x0000000000000000000000000000000000000000	0xa22ab8a9d641ce77e06d98b7d7065d324d3d6976	12000	71000	3736	1	0x2a4085d1bd2b09066fa478d50c4249b132cb674a94af3b8398056f3351ed7941
6	0x0000000000000000000000000000000000000000	0xa55a151eb00fded1634d27d1127b4be4627079ea	158000	229000	3742	0	0x7fdcaa93a36d5fafc152943c059e185d943b7a0e2172dc4e7a184c018484ca50
7	0x0000000000000000000000000000000000000000	0xa22ab8a9d641ce77e06d98b7d7065d324d3d6976	67714.285714285714285714	296714.285714285714285714	3742	0	0x7fdcaa93a36d5fafc152943c059e185d943b7a0e2172dc4e7a184c018484ca50
8	0xa55a151eb00fded1634d27d1127b4be4627079ea	0xa77a2b9d4b1c010a22a7c565dc418cef683dbcec	0.000001	296714.285715285714285714	3746	0	0x5f6ea20d3942d36d24f84d32ba9ab9eb33393538930f7a7b2e12bc821429cb50
9	0xa66a85ede0cbe03694aa9d9de0bb19c99ff55bd9	0xa88a05d2b88283ce84c8325760b72a64591279a2	0.03	296714.315715285714285714	3748	0	0x0ff860274dbcfd8a529ab8e07ce70f76bc93a027cc6e83e4c6e75eebce259448
